32
61 34 12 40 11 60 48 58 69 83 78 13 82 45 51 99 38 40 10 95 54 48 71 82 16 78 35 56 43 63 27 73
63 79 24 62 88 92 52 51 29 54 55 65 56 52 67 72 34 63 76 42 100 32 29 52 99 98 29 23 79 88 98 97
44 71 95 53 93 15 62 53 22 56 98 10 29 27 41 67 77 30 29 91 80 27 71 34 17 31 61 26 89 59 87 77
58 14 84 11 30 53 73 60 21 54 19 60 75 87 55 47 76 16 30 77 34 83 51 52 65 52 99 43 39 47 59 10
67 67 55 53 41 11 79 53 61 79 98 88 97 72 29 36 95 89 28 81 31 78 69 71 23 40 87 81 78 60 63 96
34 50 88 97 81 57 89 58 89 50 12 22 61 20 62 29 12 86 33 89 79 13 77 27 63 32 84 83 14 41 35 35
48 40 78 69 67 63 45 13 34 86 44 79 87 89 71 22 100 77 42 33 29 19 51 74 100 40 27 34 15 67 83 88
84 83 30 67 52 99 53 99 41 91 66 76 24 80 55 30 78 33 27 30 16 63 77 60 85 14 27 98 32 82 71 61
72 59 91 12 22 60 77 70 87 89 48 53 64 70 41 93 52 91 81 28 14 64 43 85 32 60 48 95 69 57 51 100
25 12 60 46 15 15 22 69 72 75 41 78 85 87 44 20 25 73 20 41 31 21 91 70 36 86 11 58 14 75 11 60
87 22 44 42 95 77 67 72 94 57 43 24 64 61 65 19 65 24 64 28 40 42 83 29 88 98 83 62 40 65 68 62
26 21 71 39 25 42 68 56 85 39 17 46 45 32 98 39 35 13 11 12 98 16 33 78 66 91 49 77 97 97 25 59
93 59 88 36 72 17 34 18 68 93 29 44 31 66 23 99 98 64 80 18 97 55 18 90 89 20 80 10 49 72 89 38
35 78 72 86 92 44 43 38 69 46 68 13 56 31 18 100 20 14 59 88 58 26 20 12 53 35 40 82 29 65 47 84
70 32 42 80 67 37 70 72 86 93 76 43 21 96 77 91 56 22 38 72 60 100 76 72 70 87 54 49 100 27 42 79
95 56 56 22 72 88 46 25 73 49 72 44 32 57 65 52 90 20 44 46 39 49 58 25 22 54 12 20 53 58 63 52
48 80 66 25 94 79 16 19 85 62 83 49 26 16 33 19 64 54 15 71 35 30 34 82 49 76 15 61 12 22 32 33
65 76 68 75 91 65 52 23 28 97 45 89 30 72 13 17 39 41 44 11 57 52 73 70 69 75 87 70 36 39 25 71
10 51 92 61 80 27 95 67 45 81 69 24 73 65 79 93 80 18 62 46 47 98 90 96 82 78 94 25 17 21 39 22
37 27 87 87 53 11 68 99 23 69 52 74 27 33 10 63 56 85 19 31 87 37 43 31 67 67 46 46 53 83 78 42
63 71 10 10 11 15 88 36 41 75 23 85 21 11 28 45 91 35 21 64 49 80 10 69 16 86 19 94 61 29 57 76
29 23 98 97 68 27 71 85 10 71 38 100 34 64 77 42 57 91 21 12 43 67 37 24 30 71 23 49 46 83 11 44
84 88 78 52 76 31 83 73 26 10 15 86 55 50 26 82 87 47 15 20 56 51 72 13 72 99 52 58 75 10 45 11
32 96 85 90 55 85 43 64 46 60 80 54 33 50 27 66 66 12 35 88 49 29 99 61 19 84 84 11 45 38 38 21
67 71 37 66 80 32 10 78 38 47 15 41 18 44 46 17 27 56 33 55 19 82 94 80 73 68 65 51 67 33 95 61
76 62 34 44 54 35 49 28 19 39 29 55 30 48 79 79 64 58 66 100 76 25 27 57 35 24 59 75 85 70 73 71
79 81 90 72 80 78 52 33 44 30 42 100 53 47 47 62 43 21 100 22 18 65 100 17 19 69 50 25 32 39 43 48
67 20 93 21 27 40 73 60 58 91 18 73 79 25 30 41 16 67 27 34 27 43 64 78 12 64 100 60 74 99 58 19
41 63 27 10 66 89 18 77 60 75 18 37 78 94 57 41 65 93 58 47 48 67 24 67 77 34 95 53 34 93 46 44
83 58 12 30 79 40 77 99 100 29 44 97 71 10 90 84 54 15 77 74 34 32 76 38 81 28 74 98 92 19 77 79
88 53 89 13 65 42 98 66 59 82 86 73 10 25 25 27 96 37 64 79 65 12 99 37 22 57 12 26 28 96 80 86
38 34 89 84 18 51 77 90 50 10 77 10 50 75 87 38 80 30 54 71 10 64 30 47 36 66 13 71 44 57 24 70
